########################################
#......................................#
#......................................#
#......................................#
#......................................#
#......................................#
#......................................#
#......................................#
#......................................#
#......................................#
#......................................#
#......................................#
#......................................#
#......................................#
#......................................#
#......................................#
#.....................................P#
#...............................########
#...............................#......#
#...............................#......#
#...............................#......#
#...............................#......#
#......................###H.....#......#
#........................#H.....#......#
#........................#H.....#......#
#P.......................#H.....#......#
#^^#####################################
#......................................#
#......................................#
########################################