##############################################
#............................................#
#............................................#
#............................................#
#............................................#
#............................................#
#............................................#
#............................................#
#............................................#
#............................................#
#............................................#
#............................................#
#............................................#
#............................................#
#............................................#
#............................................#
#............................................#
#............................................#
#............................................#
#............................................#
#............................................#
#............................................#
#............................................#
#............................................#
#............................................#
#............................................#
#............................................#
#............................................#
#P....................................P......#
##############################################