########################################
#......................................#
#......................................#
#......................................#
#......................................#
#......................................#
#......................................#
#......................................#
#......................................#
#......................................#
#......................................#
#......................................#
#......................................#
#......................................#
#......................................#
#......................................#
#......................................#
#......................................#
#......................................#
#......................................#
#..............P.......................#
#............#^^^^^....^^^#^^^^........#
#............#............#............#
#............#............#............#
#............#............#............#
#............#^^^......^^^#^^^^........#
#............#............#............#
#............#............#............#
#............#............#........P...#
########################################