########################################
#......................................#
#......................................#
#......................................#
#......................................#
#......................................#
#......................................#
#......................................#
#......................................#
#......................................#
#......................................#
#......................................#
#......................................#
#......................................#
#......................................#
#......................................#
#......................................#
#......................................#
#......................................#
#......................................#
#......................................#
#.............................#........#
#.............................#........#
#.............................#........#
#.............................#........#
#.............................#........#
#.............................#........#
#.............................#........#
#P............................#..T.P...#
########################################